----------------------------------
-                        F       -
-                       --       -
-        *         -   -         -
-                                -
-            --                 --
--                               -
-                                -
-         -         ----     -----
-                                -
--                               -
-            *                   -
-                            --- -
-         ---                    -
-                                -
-  *                        *    -
-         *                      -
-   -------------         ----   -
-                                -
-                   -            -
-                            --  -
-           ***                  -
-                                -
----------------------------------